//MAP CONVERTED BY dmm2tgm.py THIS HEADER COMMENT PREVENTS RECONVERSION, DO NOT REMOVE
"a" = (
/turf/closed/wall/mineral/snow,
/area/misc/survivalpod)
"c" = (
/obj/item/storage/backpack/duffelbag,
/obj/structure/closet/crate/wooden,
/obj/effect/spawner/random/food_or_drink/snack,
/obj/effect/spawner/random/food_or_drink/snack,
/obj/effect/spawner/random/food_or_drink/snack,
/turf/open/misc/dirt/jungle/wasteland,
/area/misc/survivalpod)
"d" = (
/obj/structure/chair/stool,
/turf/open/misc/dirt/jungle/wasteland,
/area/misc/survivalpod)
"e" = (
/obj/structure/bed/maint,
/turf/open/misc/dirt/jungle/wasteland,
/area/misc/survivalpod)
"f" = (
/obj/structure/table/wood,
/obj/effect/spawner/random/food_or_drink/dinner,
/turf/open/misc/dirt/jungle/wasteland,
/area/misc/survivalpod)
"g" = (
/obj/item/flashlight/flare/torch{
	pixel_x = 15
	},
/turf/open/misc/dirt/jungle/wasteland,
/area/misc/survivalpod)
"h" = (
/turf/open/misc/dirt/jungle/wasteland,
/area/misc/survivalpod)

(1,1,1) = {"
a
a
a
a
a
"}
(2,1,1) = {"
a
c
d
f
a
"}
(3,1,1) = {"
a
e
g
h
h
"}
(4,1,1) = {"
a
a
a
a
a
"}
