//MAP CONVERTED BY dmm2tgm.py THIS HEADER COMMENT PREVENTS RECONVERSION, DO NOT REMOVE
"aH" = (
/obj/effect/decal/remains/human,
/obj/effect/decal/cleanable/blood/old,
/obj/item/gun/ballistic/automatic/pistol/clandestine,
/turf/open/floor/iron/large,
/area/f13/bunker)
"aQ" = (
/obj/machinery/door/window{
	dir = 1
	},
/obj/structure/closet,
/turf/open/floor/iron/checker,
/area/f13/bunker)
"aW" = (
/obj/machinery/light/small,
/obj/effect/spawner/random/trash,
/turf/open/floor/iron/checker,
/area/f13/bunker)
"bC" = (
/obj/structure/closet,
/obj/item/gun/ballistic/automatic/ar/modular/m44a,
/turf/open/floor/iron/checker,
/area/f13/bunker)
"bG" = (
/obj/structure/closet/crate/radiation,
/turf/open/floor/plating,
/area/f13/bunker)
"bW" = (
/obj/structure/table,
/turf/open/floor/iron/checker,
/area/f13/bunker)
"cf" = (
/obj/machinery/light/small{
	dir = 8;
	light_color = "#d8b1b1"
	},
/turf/open/floor/iron/checker,
/area/f13/bunker)
"dj" = (
/obj/effect/decal/cleanable/dirt,
/turf/open/floor/plating,
/area/f13/bunker)
"dv" = (
/turf/open/floor/plating/elevatorshaft,
/area/f13/bunker)
"dE" = (
/obj/machinery/light/small,
/turf/open/floor/iron/checker,
/area/f13/bunker)
"ef" = (
/obj/effect/decal/remains/human,
/obj/effect/decal/cleanable/blood/old,
/obj/machinery/light/small{
	dir = 1
	},
/turf/open/floor/iron/checker,
/area/f13/bunker)
"eg" = (
/obj/structure/barricade/sandbags{
	dir = 1
	},
/obj/machinery/light/small{
	dir = 1
	},
/turf/open/floor/iron/checker,
/area/f13/bunker)
"eI" = (
/obj/structure/table,
/obj/item/reagent_containers/syringe/contraband/morphine,
/turf/open/floor/iron/checker,
/area/f13/bunker)
"eK" = (
/obj/structure/falsewall/reinforced,
/area/f13/bunker)
"fH" = (
/obj/effect/decal/cleanable/blood/old,
/obj/effect/decal/remains/human,
/turf/open/floor/iron/checker,
/area/f13/bunker)
"fQ" = (
/obj/effect/decal/cleanable/blood/old,
/turf/open/floor/iron/large,
/area/f13/bunker)
"gh" = (
/obj/effect/decal/cleanable/oil/streak,
/mob/living/simple_animal/hostile/retaliate/clown/clownhulk,
/turf/open/floor/iron/checker,
/area/f13/bunker)
"gv" = (
/obj/machinery/light/small{
	dir = 1
	},
/turf/open/floor/iron/checker,
/area/f13/bunker)
"gH" = (
/obj/structure/closet,
/obj/item/clothing/shoes/combat,
/obj/item/clothing/gloves/combat,
/turf/open/floor/iron/checker,
/area/f13/bunker)
"hd" = (
/obj/structure/closet,
/obj/item/gun/ballistic/automatic/pistol/m1911,
/turf/open/floor/iron/checker,
/area/f13/bunker)
"iO" = (
/obj/machinery/chem_dispenser,
/turf/open/floor/iron/checker,
/area/f13/bunker)
"jx" = (
/obj/item/stack/sheet/mineral/uranium{
	amount = 5
	},
/turf/open/floor/plating,
/area/f13/bunker)
"jQ" = (
/obj/machinery/door/airlock/hatch,
/turf/open/floor/plating,
/area/f13/bunker)
"jX" = (
/obj/machinery/light/small{
	dir = 4
	},
/obj/structure/spider/stickyweb,
/turf/open/floor/iron/checker,
/area/f13/bunker)
"lw" = (
/obj/machinery/door/window{
	dir = 4
	},
/obj/structure/closet,
/turf/open/floor/iron/checker,
/area/f13/bunker)
"lH" = (
/obj/structure/chair,
/obj/effect/decal/remains/human,
/obj/item/stack/sheet/animalhide/human,
/turf/open/floor/plating,
/area/f13/bunker)
"lS" = (
/obj/effect/decal/cleanable/oil/streak,
/turf/open/floor/iron/checker,
/area/f13/bunker)
"mb" = (
/obj/effect/decal/cleanable/oil/streak,
/turf/open/floor/iron/large,
/area/f13/bunker)
"na" = (
/obj/effect/decal/remains/human,
/obj/structure/closet,
/turf/open/floor/plating,
/area/f13/bunker)
"ne" = (
/obj/machinery/door/window,
/obj/structure/closet,
/turf/open/floor/iron/checker,
/area/f13/bunker)
"nD" = (
/obj/machinery/door/airlock/hatch,
/turf/open/floor/iron/large,
/area/f13/bunker)
"nK" = (
/obj/structure/closet,
/obj/item/storage/box/gloves,
/turf/open/floor/iron/checker,
/area/f13/bunker)
"nV" = (
/obj/structure/table,
/obj/item/clothing/accessory/armband/med,
/turf/open/floor/iron/checker,
/area/f13/bunker)
"nW" = (
/mob/living/simple_animal/hostile/evilborg/protect,
/turf/open/floor/iron/large,
/area/f13/bunker)
"op" = (
/obj/machinery/light/small{
	dir = 8
	},
/mob/living/simple_animal/hostile/scorpion,
/turf/open/floor/iron/checker,
/area/f13/bunker)
"oy" = (
/obj/structure/barricade/sandbags{
	dir = 8
	},
/obj/effect/decal/remains/human,
/turf/open/floor/iron/checker,
/area/f13/bunker)
"pd" = (
/obj/effect/decal/cleanable/oil/streak,
/obj/structure/closet,
/turf/open/floor/iron/checker,
/area/f13/bunker)
"po" = (
/obj/structure/rack,
/turf/open/floor/plating,
/area/f13/bunker)
"pq" = (
/obj/effect/decal/cleanable/oil/streak,
/obj/machinery/light/small{
	dir = 8
	},
/turf/open/floor/iron/checker,
/area/f13/bunker)
"pB" = (
/obj/structure/chair{
	dir = 8
	},
/obj/effect/decal/remains/human,
/turf/open/floor/plating,
/area/f13/bunker)
"pP" = (
/turf/closed/wall/r_wall,
/area/f13/bunker)
"qj" = (
/turf/closed/indestructible/fakeglass,
/area/f13/bunker)
"qk" = (
/obj/structure/closet,
/obj/item/food/grown/ambrosia/gaia,
/obj/item/gun/energy/pulse/pistol/m1911,
/obj/item/book/granter/crafting_recipe/dusting/laser_musket_prime,
/turf/open/floor/iron/large,
/area/f13/bunker)
"qy" = (
/obj/structure/spider/stickyweb,
/obj/structure/closet,
/obj/item/food/canned/peaches,
/turf/open/floor/plating,
/area/f13/bunker)
"qA" = (
/obj/structure/chair,
/obj/effect/decal/remains/human,
/turf/open/floor/iron/checker,
/area/f13/bunker)
"qJ" = (
/obj/machinery/door/airlock/hatch,
/turf/open/floor/iron/checker,
/area/f13/bunker)
"qN" = (
/obj/structure/table,
/obj/machinery/computer/terminal{
	dir = 1;
	termtag = "Business"
	},
/turf/open/floor/iron/checker,
/area/f13/bunker)
"rr" = (
/obj/machinery/light/small{
	dir = 1
	},
/obj/effect/spawner/random/contraband/landmine,
/turf/open/floor/iron/checker,
/area/f13/bunker)
"rG" = (
/obj/structure/spider/stickyweb,
/turf/open/floor/plating,
/area/f13/radiation)
"sy" = (
/obj/effect/decal/remains/human,
/obj/effect/decal/cleanable/blood/old,
/turf/open/floor/iron/checker,
/area/f13/bunker)
"ti" = (
/obj/structure/closet/crate/bin,
/turf/open/floor/plating,
/area/f13/bunker)
"tJ" = (
/obj/structure/closet,
/obj/item/gun/ballistic/shotgun/automatic/as2,
/turf/open/floor/iron/checker,
/area/f13/bunker)
"tQ" = (
/obj/item/gun/ballistic/automatic/pistol/mk58,
/turf/open/floor/iron/large,
/area/f13/bunker)
"ud" = (
/obj/structure/door_assembly/door_assembly_hatch,
/area/f13/bunker)
"us" = (
/mob/living/basic/mold/centaur,
/turf/open/floor/plating,
/area/f13/bunker)
"uC" = (
/obj/structure/table,
/obj/item/paper,
/turf/open/floor/plating,
/area/f13/bunker)
"uQ" = (
/obj/structure/sink{
	dir = 8;
	pixel_x = -10
	},
/obj/structure/mirror{
	pixel_x = -32
	},
/turf/open/floor/iron/checker,
/area/f13/bunker)
"uS" = (
/obj/machinery/vending/cola/space_up,
/turf/open/floor/iron/checker,
/area/f13/bunker)
"vh" = (
/obj/machinery/door/airlock/hatch,
/area/f13/bunker)
"vO" = (
/turf/open/floor/plating,
/area/f13/bunker)
"wh" = (
/obj/effect/decal/cleanable/blood/old,
/turf/open/floor/plating,
/area/f13/bunker)
"wD" = (
/turf/open/floor/iron/large,
/area/f13/bunker)
"wN" = (
/obj/structure/table,
/obj/item/stack/spacecash/c1000,
/turf/open/floor/iron/checker,
/area/f13/bunker)
"wO" = (
/obj/machinery/light/small{
	dir = 8
	},
/turf/open/floor/iron/checker,
/area/f13/bunker)
"wU" = (
/obj/structure/chair{
	dir = 8
	},
/turf/open/floor/iron/checker,
/area/f13/bunker)
"xG" = (
/turf/closed/wall/r_wall/rust,
/area/f13/bunker)
"xL" = (
/obj/structure/rack,
/obj/item/stack/sheet/mineral/uranium{
	amount = 5
	},
/turf/open/floor/plating,
/area/f13/bunker)
"xV" = (
/mob/living/simple_animal/hostile/evilborg/bigguy,
/turf/open/floor/iron/large,
/area/f13/bunker)
"yf" = (
/obj/effect/decal/remains/human,
/obj/structure/chair/stool/directional/north,
/turf/open/floor/iron/checker,
/area/f13/bunker)
"yq" = (
/obj/item/mop,
/obj/machinery/light/small{
	dir = 1
	},
/turf/open/floor/iron/checker,
/area/f13/bunker)
"yB" = (
/obj/structure/closet,
/obj/item/book/granter/martial/carp,
/turf/open/floor/iron/large,
/area/f13/bunker)
"yT" = (
/obj/structure/closet,
/obj/item/gun/ballistic/rifle/boltaction,
/turf/open/floor/iron/checker,
/area/f13/bunker)
"zu" = (
/obj/structure/table,
/obj/item/reagent_containers/cup/bottle/sodium_thiopental,
/turf/open/floor/plating,
/area/f13/bunker)
"zJ" = (
/obj/structure/closet,
/obj/item/ammo_box/magazine/m44a,
/turf/open/floor/iron/checker,
/area/f13/bunker)
"Ae" = (
/obj/structure/table,
/obj/item/surgical_drapes,
/obj/item/surgicaldrill,
/turf/open/floor/iron/checker,
/area/f13/bunker)
"As" = (
/obj/effect/decal/cleanable/greenglow/filled,
/obj/item/book/granter/crafting_recipe/regal_condor,
/turf/open/floor/plating,
/area/f13/bunker)
"Bp" = (
/obj/structure/chair/stool/directional,
/turf/open/floor/iron/checker,
/area/f13/bunker)
"Bw" = (
/obj/effect/spawner/random/trash,
/turf/open/floor/iron/checker,
/area/f13/bunker)
"Bx" = (
/obj/structure/bed,
/turf/open/floor/plating,
/area/f13/bunker)
"BA" = (
/obj/effect/decal/cleanable/vomit/old,
/turf/open/floor/iron/checker,
/area/f13/bunker)
"BH" = (
/obj/item/stack/spacecash/c500,
/turf/open/floor/iron/large,
/area/f13/bunker)
"BZ" = (
/obj/structure/closet/crate/secure/weapon,
/obj/item/grenade/smokebomb,
/obj/item/grenade/smokebomb,
/turf/open/floor/iron/checker,
/area/f13/bunker)
"Cm" = (
/obj/structure/closet/crate/secure/weapon,
/turf/open/floor/plating,
/area/f13/bunker)
"Dv" = (
/obj/item/microfusion_gun_attachment/scope,
/obj/item/microfusion_gun_attachment/grip,
/turf/open/floor/plating,
/area/f13/bunker)
"Dx" = (
/obj/structure/closet/crate/bin,
/turf/open/floor/iron/checker,
/area/f13/bunker)
"DA" = (
/obj/item/paper,
/obj/item/pen,
/obj/structure/table,
/turf/open/floor/iron/checker,
/area/f13/bunker)
"DZ" = (
/obj/structure/table,
/obj/structure/window/reinforced,
/obj/structure/window/reinforced{
	dir = 4
	},
/turf/open/floor/iron/checker,
/area/f13/bunker)
"Eb" = (
/obj/structure/bed,
/turf/open/floor/iron/checker,
/area/f13/bunker)
"Eg" = (
/turf/closed/indestructible/riveted/plastinum/nodiagonal,
/area/f13/bunker)
"EB" = (
/obj/item/melee/baseball_bat/homerun,
/turf/open/floor/plating,
/area/f13/bunker)
"EP" = (
/obj/structure/closet,
/obj/item/clothing/gloves/combat,
/obj/item/clothing/shoes/combat,
/turf/open/floor/iron/checker,
/area/f13/bunker)
"ER" = (
/obj/effect/decal/remains/human,
/obj/effect/decal/cleanable/blood/old,
/turf/open/floor/iron/large,
/area/f13/bunker)
"ES" = (
/obj/machinery/light/small{
	dir = 4
	},
/turf/open/floor/iron/checker,
/area/f13/bunker)
"Ff" = (
/obj/structure/door_assembly/door_assembly_hatch,
/turf/open/floor/plating,
/area/f13/bunker)
"Fr" = (
/obj/item/stack/sheet/animalhide/human,
/turf/open/floor/plating,
/area/f13/bunker)
"Gg" = (
/obj/structure/chair{
	dir = 4
	},
/turf/open/floor/iron/checker,
/area/f13/bunker)
"Gn" = (
/obj/machinery/chem_heater,
/turf/open/floor/iron/checker,
/area/f13/bunker)
"He" = (
/obj/effect/decal/remains/human,
/obj/effect/decal/cleanable/vomit/old,
/turf/open/floor/iron/checker,
/area/f13/bunker)
"HB" = (
/obj/structure/girder/reinforced,
/turf/open/floor/plating,
/area/f13/bunker)
"ID" = (
/obj/item/seeds/tower/steel,
/obj/structure/closet,
/obj/item/clothing/suit/space/hev_suit/nri,
/obj/item/clothing/head/helmet/space/hev_suit/nri,
/obj/item/book/granter/crafting_recipe/combat_baking,
/turf/open/floor/iron/large,
/area/f13/bunker)
"IT" = (
/obj/effect/decal/remains/human,
/obj/item/flashlight/flare/torch,
/turf/open/floor/plating,
/area/f13/bunker)
"IZ" = (
/obj/structure/table,
/obj/item/scalpel,
/obj/item/cautery,
/obj/item/razor,
/turf/open/floor/iron/checker,
/area/f13/bunker)
"Jq" = (
/obj/structure/spider/stickyweb,
/turf/open/floor/plating,
/area/f13/bunker)
"Jv" = (
/obj/structure/table,
/obj/machinery/light/small,
/obj/machinery/recharger,
/turf/open/floor/iron/checker,
/area/f13/bunker)
"JF" = (
/turf/open/floor/iron/checker,
/area/f13/bunker)
"Kk" = (
/obj/effect/decal/cleanable/greenglow/filled,
/turf/open/floor/plating,
/area/f13/bunker)
"LC" = (
/obj/structure/table/optable,
/turf/open/floor/iron/checker,
/area/f13/bunker)
"LF" = (
/obj/effect/decal/remains/human,
/turf/open/floor/plating,
/area/f13/bunker)
"LS" = (
/obj/effect/decal/remains/human,
/obj/effect/decal/cleanable/vomit/old,
/obj/structure/chair/stool/directional,
/turf/open/floor/iron/checker,
/area/f13/bunker)
"Mj" = (
/obj/machinery/shower{
	pixel_y = 22
	},
/obj/effect/decal/cleanable/vomit/old,
/obj/machinery/light/small{
	dir = 8
	},
/obj/structure/spider/stickyweb,
/turf/open/floor/iron/checker,
/area/f13/bunker)
"Ny" = (
/mob/living/simple_animal/hostile/retaliate/clown/clownhulk,
/turf/open/floor/plating,
/area/f13/bunker)
"Od" = (
/mob/living/simple_animal/hostile/scorpion,
/turf/open/floor/iron/checker,
/area/f13/bunker)
"Oi" = (
/obj/docking_port/stationary{
	dir = 2;
	dwidth = 1;
	height = 3;
	id = "North_Level_1";
	name = "Level 1";
	width = 4
	},
/turf/open/floor/plating/elevatorshaft,
/area/f13/bunker)
"Oz" = (
/obj/structure/closet/crate/freezer/blood,
/obj/machinery/light/small{
	dir = 4
	},
/turf/open/floor/iron/checker,
/area/f13/bunker)
"OG" = (
/obj/structure/table,
/turf/open/floor/plating,
/area/f13/bunker)
"OV" = (
/obj/structure/table,
/obj/item/storage/box/syringes,
/obj/item/storage/box/beakers,
/turf/open/floor/iron/checker,
/area/f13/bunker)
"PW" = (
/turf/closed/indestructible/opshuttle,
/area/f13/bunker)
"Qe" = (
/obj/structure/closet,
/obj/item/clothing/shoes/combat,
/obj/item/clothing/gloves/combat,
/obj/item/clothing/suit/armor/riot/skinsuit_armor,
/turf/open/floor/iron/checker,
/area/f13/bunker)
"QC" = (
/obj/structure/table,
/obj/item/retractor,
/obj/item/hemostat,
/turf/open/floor/iron/checker,
/area/f13/bunker)
"Ra" = (
/obj/structure/spider/stickyweb,
/turf/open/floor/iron/checker,
/area/f13/bunker)
"RD" = (
/obj/structure/table,
/obj/item/storage/belt/medical,
/turf/open/floor/iron/checker,
/area/f13/bunker)
"SI" = (
/obj/machinery/chem_master,
/turf/open/floor/iron/checker,
/area/f13/bunker)
"TL" = (
/obj/structure/closet/crate/solarpanel_small,
/turf/open/floor/plating,
/area/f13/bunker)
"TQ" = (
/obj/structure/chair/stool/directional,
/obj/effect/spawner/random/trash,
/turf/open/floor/iron/checker,
/area/f13/bunker)
"TU" = (
/obj/effect/decal/cleanable/blood/old,
/obj/structure/barricade/sandbags{
	dir = 8
	},
/turf/open/floor/iron/checker,
/area/f13/bunker)
"TZ" = (
/mob/living/simple_animal/hostile/retaliate/clown/clownhulk,
/turf/open/floor/iron/checker,
/area/f13/bunker)
"UE" = (
/obj/structure/table,
/obj/machinery/computer/terminal{
	dir = 8;
	termtag = "Business"
	},
/turf/open/floor/iron/checker,
/area/f13/bunker)
"UX" = (
/obj/effect/decal/cleanable/blood/old,
/turf/open/floor/iron/checker,
/area/f13/bunker)
"Vh" = (
/obj/structure/closet/crate/radiation,
/obj/item/stack/sheet/mineral/uranium{
	amount = 5
	},
/obj/item/stack/sheet/mineral/uranium{
	amount = 5
	},
/obj/item/stack/sheet/mineral/uranium{
	amount = 5
	},
/turf/open/floor/plating,
/area/f13/bunker)
"Vu" = (
/obj/machinery/shower{
	pixel_y = 22
	},
/obj/effect/decal/cleanable/vomit/old,
/turf/open/floor/plating,
/area/f13/bunker)
"VZ" = (
/obj/structure/closet,
/obj/item/stack/spacecash/c100,
/turf/open/floor/iron/checker,
/area/f13/bunker)
"Wj" = (
/obj/structure/chair,
/turf/open/floor/iron/checker,
/area/f13/bunker)
"Wr" = (
/obj/structure/toilet{
	dir = 8
	},
/turf/open/floor/iron/checker,
/area/f13/bunker)
"Xc" = (
/obj/effect/decal/remains/human,
/obj/effect/decal/cleanable/blood/old,
/turf/open/floor/plating,
/area/f13/bunker)
"Xv" = (
/obj/structure/closet,
/turf/open/floor/plating,
/area/f13/bunker)
"XL" = (
/obj/effect/decal/cleanable/oil/streak,
/obj/machinery/light/small{
	dir = 1
	},
/turf/open/floor/iron/checker,
/area/f13/bunker)
"XY" = (
/turf/closed/indestructible/rock,
/area/f13/caves)
"Zc" = (
/mob/living/simple_animal/hostile/evilborg/protect,
/turf/open/floor/iron/checker,
/area/f13/bunker)
"Zg" = (
/obj/machinery/door/window{
	dir = 4
	},
/turf/open/floor/iron/checker,
/area/f13/bunker)
"Zp" = (
/obj/structure/grille,
/obj/structure/window/reinforced/fulltile,
/turf/open/floor/iron/checker,
/area/f13/bunker)
"Zx" = (
/obj/structure/chair/stool/directional/north,
/turf/open/floor/iron/checker,
/area/f13/bunker)

(1,1,1) = {"
XY
XY
XY
XY
XY
XY
XY
XY
XY
XY
XY
XY
XY
XY
XY
XY
XY
XY
XY
XY
XY
XY
XY
XY
XY
XY
XY
XY
XY
XY
XY
XY
XY
XY
XY
XY
"}
(2,1,1) = {"
XY
XY
XY
XY
XY
XY
XY
XY
XY
XY
XY
XY
XY
XY
XY
XY
XY
XY
XY
XY
XY
XY
XY
XY
XY
XY
XY
XY
XY
XY
XY
XY
XY
XY
XY
XY
"}
(3,1,1) = {"
XY
XY
XY
XY
XY
XY
XY
Eg
Eg
Eg
Eg
XY
XY
XY
XY
XY
XY
XY
XY
XY
XY
XY
XY
XY
XY
XY
XY
XY
XY
XY
XY
XY
XY
XY
XY
XY
"}
(4,1,1) = {"
XY
XY
XY
XY
XY
XY
XY
Eg
ID
qk
Eg
XY
XY
XY
XY
XY
XY
XY
XY
XY
XY
XY
XY
XY
XY
XY
XY
XY
XY
XY
XY
XY
XY
XY
XY
XY
"}
(5,1,1) = {"
XY
XY
XY
XY
XY
XY
XY
Eg
nD
nD
Eg
XY
XY
XY
XY
XY
XY
XY
XY
XY
XY
XY
XY
XY
XY
XY
XY
XY
XY
XY
XY
XY
XY
XY
XY
XY
"}
(6,1,1) = {"
XY
XY
XY
XY
XY
XY
Eg
wD
wD
wD
wD
Eg
XY
XY
XY
XY
XY
XY
XY
XY
XY
XY
XY
XY
XY
XY
XY
XY
XY
XY
XY
XY
XY
XY
XY
XY
"}
(7,1,1) = {"
XY
XY
XY
XY
XY
Eg
wD
wD
xV
wD
wD
wD
Eg
XY
XY
XY
XY
XY
XY
XY
XY
XY
XY
XY
XY
XY
XY
XY
XY
XY
XY
XY
XY
XY
XY
XY
"}
(8,1,1) = {"
XY
XY
XY
XY
Eg
wD
wD
wD
wD
mb
wD
wD
wD
Eg
XY
XY
XY
XY
XY
XY
XY
XY
XY
XY
XY
XY
XY
XY
XY
XY
XY
XY
XY
XY
XY
XY
"}
(9,1,1) = {"
XY
XY
XY
Eg
wD
wD
mb
wD
wD
wD
wD
wD
wD
wD
Eg
XY
XY
XY
XY
XY
XY
XY
XY
xG
xG
xG
xG
xG
xG
XY
XY
XY
XY
XY
XY
XY
"}
(10,1,1) = {"
XY
XY
Eg
yB
wD
wD
wD
nW
aH
wD
wD
wD
wD
wD
nW
Eg
XY
XY
XY
XY
XY
XY
XY
xG
As
EB
jx
Kk
xG
XY
XY
XY
XY
XY
XY
XY
"}
(11,1,1) = {"
XY
XY
Eg
wD
wD
wD
wD
wD
mb
wD
wD
wD
wD
wD
BH
Eg
XY
XY
XY
XY
XY
XY
XY
xG
us
vO
Kk
Dv
xG
XY
XY
XY
XY
XY
XY
XY
"}
(12,1,1) = {"
XY
XY
Eg
wD
wD
wD
wD
wD
wD
wD
wD
wD
wD
tQ
wD
Eg
XY
XY
XY
XY
XY
XY
XY
xG
Kk
vO
vO
Kk
xG
XY
XY
XY
XY
XY
XY
XY
"}
(13,1,1) = {"
XY
XY
Eg
nW
wD
wD
wD
wD
fQ
wD
wD
ER
wD
wD
wD
Eg
XY
XY
XY
xG
xG
xG
xG
xG
vh
xG
xG
xG
xG
xG
xG
xG
XY
XY
XY
XY
"}
(14,1,1) = {"
XY
XY
XY
Eg
wD
wD
mb
wD
wD
nW
wD
wD
wD
wD
Eg
XY
XY
XY
XY
xG
uQ
JF
qJ
JF
JF
xG
hd
Eb
Qe
Eb
yT
xG
XY
XY
XY
XY
"}
(15,1,1) = {"
XY
XY
XY
XY
Eg
wD
wD
ER
wD
wD
mb
xV
wD
Eg
XY
XY
XY
XY
XY
xG
yq
JF
xG
lS
oy
xG
gv
JF
Zc
JF
dE
xG
XY
XY
XY
XY
"}
(16,1,1) = {"
XY
XY
XY
XY
XY
Eg
nW
wD
wD
wD
wD
wD
Eg
XY
XY
xG
xG
xG
xG
xG
Wr
pd
xG
gv
JF
xG
JF
Bp
eI
Zx
Bw
xG
XY
XY
XY
XY
"}
(17,1,1) = {"
XY
XY
XY
XY
XY
XY
Eg
wD
wD
wD
wD
Eg
XY
XY
XY
xG
OV
cf
JF
xG
xG
xG
xG
TZ
JF
qJ
JF
LS
eI
Zx
JF
xG
XY
XY
XY
XY
"}
(18,1,1) = {"
XY
XY
XY
XY
XY
XY
XY
Eg
qJ
qJ
Eg
XY
XY
XY
XY
xG
SI
BA
JF
JF
JF
Gg
xG
JF
sy
xG
JF
TQ
wN
yf
JF
xG
XY
XY
XY
XY
"}
(19,1,1) = {"
XY
XY
XY
XY
XY
XY
XY
Eg
UX
JF
Eg
XY
XY
XY
XY
xG
iO
JF
gh
Dx
nV
RD
xG
gv
JF
xG
gv
lS
Zc
JF
dE
xG
XY
XY
XY
XY
"}
(20,1,1) = {"
XY
XY
XY
XY
XY
XY
XY
Eg
JF
JF
Eg
XY
XY
XY
XY
xG
Gn
JF
JF
ES
JF
JF
xG
JF
JF
xG
gH
Eb
VZ
Eb
gH
xG
XY
XY
XY
XY
"}
(21,1,1) = {"
XY
XY
XY
XY
XY
XY
XY
Eg
Zc
Zc
Eg
xG
xG
xG
xG
xG
Zp
qJ
Zp
xG
xG
qJ
xG
JF
JF
xG
xG
xG
xG
xG
xG
xG
XY
XY
XY
XY
"}
(22,1,1) = {"
XY
XY
XY
XY
XY
XY
XY
Eg
JF
UX
Eg
xG
EP
TZ
EP
xG
QC
JF
nK
xG
Dx
BA
JF
JF
Bw
xG
XY
XY
XY
XY
XY
XY
XY
XY
XY
XY
"}
(23,1,1) = {"
XY
XY
XY
XY
XY
XY
XY
Eg
JF
JF
Eg
xG
xG
gv
xG
xG
IZ
BA
LC
xG
gv
JF
JF
xG
xG
xG
XY
XY
XY
XY
XY
XY
XY
XY
XY
XY
"}
(24,1,1) = {"
XY
XY
XY
XY
XY
XY
XY
Eg
gv
JF
Eg
xG
ne
JF
aQ
xG
Ae
Oz
JF
xG
JF
sy
JF
xG
XY
XY
XY
XY
XY
XY
XY
XY
XY
XY
XY
XY
"}
(25,1,1) = {"
XY
XY
XY
XY
XY
XY
XY
Eg
JF
JF
Eg
xG
xG
ef
xG
xG
xG
xG
xG
xG
JF
xG
xG
xG
XY
XY
XY
XY
XY
XY
XY
XY
XY
XY
XY
XY
"}
(26,1,1) = {"
XY
XY
XY
XY
XY
xG
xG
xG
qJ
qJ
xG
xG
ne
lS
aQ
xG
Dx
JF
JF
qJ
JF
xG
XY
XY
XY
XY
XY
XY
XY
XY
XY
XY
XY
XY
XY
XY
"}
(27,1,1) = {"
XY
XY
XY
XY
XY
xG
qA
qN
JF
JF
bW
xG
BZ
TZ
JF
xG
eg
TU
JF
xG
xG
xG
XY
XY
XY
XY
XY
XY
XY
XY
XY
XY
XY
XY
XY
XY
"}
(28,1,1) = {"
XY
XY
XY
XY
XY
xG
Zg
DZ
JF
JF
Jv
xG
xG
qJ
xG
xG
JF
sy
JF
xG
XY
XY
XY
XY
XY
XY
XY
XY
XY
XY
XY
XY
XY
XY
XY
XY
"}
(29,1,1) = {"
XY
XY
XY
XY
XY
xG
JF
JF
JF
lS
wU
xG
wO
lS
JF
xG
JF
JF
dE
xG
XY
XY
XY
XY
XY
XY
XY
XY
XY
XY
XY
XY
XY
XY
XY
XY
"}
(30,1,1) = {"
XY
XY
XY
XY
XY
xG
uS
ES
JF
Bw
JF
qJ
JF
JF
Bw
qJ
JF
Od
JF
xG
XY
XY
XY
XY
XY
XY
XY
XY
XY
XY
XY
XY
XY
XY
XY
XY
"}
(31,1,1) = {"
XY
XY
xG
xG
xG
xG
xG
xG
qJ
xG
xG
xG
JF
He
JF
xG
Bw
JF
JF
xG
XY
XY
XY
XY
XY
XY
XY
XY
XY
XY
XY
XY
XY
XY
XY
XY
"}
(32,1,1) = {"
XY
XY
xG
bC
Bw
xG
lw
JF
JF
wO
JF
xG
xG
qJ
xG
xG
JF
JF
aW
xG
XY
XY
XY
XY
XY
XY
XY
XY
XY
XY
XY
XY
XY
XY
XY
XY
"}
(33,1,1) = {"
XY
XY
xG
rr
JF
xG
gv
JF
sy
Wj
qN
Zp
op
JF
pq
Od
JF
fH
Bw
xG
XY
XY
XY
XY
XY
XY
XY
XY
XY
XY
XY
XY
XY
XY
XY
XY
"}
(34,1,1) = {"
XY
XY
xG
tJ
JF
qJ
JF
TZ
JF
JF
DA
Zp
sy
JF
JF
JF
JF
JF
JF
xG
XY
XY
XY
XY
XY
XY
XY
XY
XY
XY
XY
XY
XY
XY
XY
XY
"}
(35,1,1) = {"
XY
XY
xG
ef
JF
xG
XL
JF
Gg
Bw
JF
xG
xG
qJ
xG
xG
xG
vh
xG
xG
xG
xG
xG
xG
xG
xG
XY
XY
XY
XY
XY
XY
XY
XY
XY
XY
"}
(36,1,1) = {"
XY
XY
xG
zJ
JF
xG
JF
bW
UE
ES
Dx
xG
Mj
Ra
wO
JF
wO
JF
wO
JF
PW
PW
PW
PW
PW
xG
XY
XY
XY
XY
XY
XY
XY
XY
XY
XY
"}
(37,1,1) = {"
XY
XY
xG
xG
xG
xG
xG
xG
xG
xG
xG
xG
Ra
JF
JF
JF
Od
JF
JF
JF
qj
dv
dv
dv
PW
xG
XY
XY
XY
XY
XY
XY
XY
XY
XY
XY
"}
(38,1,1) = {"
XY
XY
xG
XY
XY
XY
XY
XY
XY
XY
XY
xG
JF
Od
JF
JF
JF
JF
sy
JF
JF
dv
dv
dv
PW
xG
XY
XY
XY
XY
XY
XY
XY
XY
XY
XY
"}
(39,1,1) = {"
XY
XY
xG
XY
XY
XY
XY
XY
XY
XY
XY
xG
gv
JF
sy
Ra
JF
Bw
JF
JF
JF
Oi
dv
dv
PW
xG
XY
XY
XY
XY
XY
XY
XY
XY
XY
XY
"}
(40,1,1) = {"
XY
XY
xG
xG
xG
xG
xG
xG
xG
xG
xG
xG
xG
jQ
xG
xG
JF
JF
JF
Od
qj
dv
dv
dv
PW
xG
XY
XY
XY
XY
XY
XY
XY
XY
XY
XY
"}
(41,1,1) = {"
XY
XY
XY
XY
Jq
HB
OG
vO
vO
Jq
vO
xG
Vu
vO
vO
xG
JF
JF
JF
JF
PW
PW
PW
PW
PW
xG
XY
XY
XY
XY
XY
XY
XY
XY
XY
XY
"}
(42,1,1) = {"
XY
XY
XY
LF
Fr
xG
vO
Ny
vO
Jq
Jq
xG
xG
Ff
xG
xG
JF
Od
JF
xG
xG
xG
xG
xG
xG
xG
XY
XY
XY
XY
XY
XY
XY
XY
XY
XY
"}
(43,1,1) = {"
XY
XY
XY
zu
vO
Jq
wh
vO
Vh
Jq
OG
vO
IT
vO
Jq
xG
JF
JF
dE
xG
XY
XY
XY
XY
XY
XY
XY
XY
XY
XY
XY
XY
XY
XY
XY
XY
"}
(44,1,1) = {"
XY
XY
XY
qy
vO
xG
Jq
lH
vO
vO
vO
vO
Jq
Jq
vO
xG
UX
JF
Ra
xG
XY
XY
XY
XY
XY
XY
XY
XY
XY
XY
XY
XY
XY
XY
XY
XY
"}
(45,1,1) = {"
XY
XY
XY
XY
Xc
xG
Jq
vO
vO
vO
rG
xG
xG
Ff
xG
xG
JF
Od
Bw
xG
XY
XY
XY
XY
XY
XY
XY
XY
XY
XY
XY
XY
XY
XY
XY
XY
"}
(46,1,1) = {"
XY
XY
XY
XY
xG
xG
HB
xG
Jq
xG
HB
xG
wh
dj
Fr
xG
Ra
JF
UX
xG
XY
XY
XY
XY
XY
XY
XY
XY
XY
XY
XY
XY
XY
XY
XY
XY
"}
(47,1,1) = {"
XY
XY
XY
XY
XY
xG
LF
vO
vO
vO
vO
Ff
Jq
vO
LF
Ff
Bw
jX
Dx
xG
XY
XY
XY
XY
XY
XY
XY
XY
XY
XY
XY
XY
XY
XY
XY
XY
"}
(48,1,1) = {"
XY
XY
XY
XY
XY
XY
Xv
OG
Ny
vO
Jq
xG
vO
Jq
Jq
xG
Jq
xG
xG
xG
XY
XY
XY
XY
XY
XY
XY
XY
XY
XY
XY
XY
XY
XY
XY
XY
"}
(49,1,1) = {"
XY
XY
XY
XY
XY
XY
XY
Jq
vO
Cm
vO
xG
xG
jQ
xG
xG
Jq
Jq
dj
xG
XY
XY
XY
XY
XY
XY
XY
XY
XY
XY
XY
XY
XY
XY
XY
XY
"}
(50,1,1) = {"
XY
XY
XY
XY
XY
XY
XY
XY
LF
Fr
LF
xG
Jq
vO
ti
xG
vO
Jq
vO
xG
xG
xG
XY
XY
XY
XY
XY
XY
XY
XY
XY
XY
XY
XY
XY
XY
"}
(51,1,1) = {"
XY
XY
XY
XY
XY
XY
XY
XY
Jq
Jq
xG
HB
Jq
Jq
OG
xG
vO
LF
Fr
vO
Jq
xG
XY
XY
XY
XY
XY
XY
XY
XY
XY
XY
XY
XY
XY
XY
"}
(52,1,1) = {"
XY
XY
XY
XY
XY
XY
XY
XY
XY
XY
XY
xG
Xc
Jq
Jq
pP
xG
xG
pP
pP
Jq
xG
xG
xG
XY
XY
XY
XY
XY
XY
XY
XY
XY
XY
XY
XY
"}
(53,1,1) = {"
XY
XY
XY
XY
XY
XY
XY
XY
XY
XY
XY
XY
XY
Xv
Jq
xG
xL
vO
uC
xG
Jq
vO
TL
xG
XY
XY
XY
XY
XY
XY
XY
XY
XY
XY
XY
XY
"}
(54,1,1) = {"
XY
XY
XY
XY
XY
XY
XY
XY
XY
XY
XY
XY
XY
XY
LF
eK
vO
vO
pB
xG
bG
dj
wh
xG
xG
xG
XY
XY
XY
XY
XY
XY
XY
XY
XY
XY
"}
(55,1,1) = {"
XY
XY
XY
XY
XY
XY
XY
XY
XY
XY
XY
XY
XY
XY
XY
xG
po
vO
Xv
pP
Xv
LF
Jq
Jq
dj
xG
XY
XY
XY
XY
XY
XY
XY
XY
XY
XY
"}
(56,1,1) = {"
XY
XY
XY
XY
XY
XY
XY
XY
XY
XY
XY
XY
XY
XY
XY
pP
pP
jQ
pP
xG
XY
XY
xG
Jq
vO
xG
xG
xG
xG
xG
xG
xG
XY
XY
XY
XY
"}
(57,1,1) = {"
XY
XY
XY
XY
XY
XY
XY
XY
XY
XY
XY
XY
XY
XY
XY
pP
vO
vO
vO
XY
xG
XY
pP
vO
Jq
xG
vO
vO
vO
vO
OG
xG
XY
XY
XY
XY
"}
(58,1,1) = {"
XY
XY
XY
XY
XY
XY
XY
XY
XY
XY
XY
XY
XY
XY
XY
xG
vO
vO
XY
XY
xG
XY
HB
vO
vO
HB
vO
wh
vO
vO
vO
xG
XY
XY
XY
XY
"}
(59,1,1) = {"
XY
XY
XY
XY
XY
XY
XY
XY
XY
XY
XY
XY
XY
XY
XY
xG
Xv
XY
XY
xG
XY
xG
pP
vO
vO
xG
dj
vO
Xv
vO
LF
xG
XY
XY
XY
XY
"}
(60,1,1) = {"
XY
XY
XY
XY
XY
XY
XY
XY
XY
XY
XY
XY
XY
XY
XY
pP
pP
xG
xG
XY
XY
XY
xG
vO
dj
ud
LF
Fr
vO
Bx
XY
xG
XY
XY
XY
XY
"}
(61,1,1) = {"
XY
XY
XY
XY
XY
XY
XY
XY
XY
XY
XY
XY
XY
XY
XY
XY
XY
XY
XY
XY
vO
Jq
HB
wh
vO
xG
vO
vO
vO
XY
XY
xG
XY
XY
XY
XY
"}
(62,1,1) = {"
XY
XY
XY
XY
XY
XY
XY
XY
XY
XY
XY
XY
XY
XY
XY
XY
XY
XY
XY
XY
XY
Jq
vO
Jq
LF
xG
vO
vO
XY
XY
XY
xG
XY
XY
XY
XY
"}
(63,1,1) = {"
XY
XY
XY
XY
XY
XY
XY
XY
XY
XY
XY
XY
XY
XY
XY
XY
XY
XY
XY
XY
XY
vO
jQ
Jq
Jq
xG
OG
XY
XY
XY
XY
xG
XY
XY
XY
XY
"}
(64,1,1) = {"
XY
XY
XY
XY
XY
XY
XY
XY
XY
XY
XY
XY
XY
XY
XY
XY
XY
XY
XY
XY
XY
XY
xG
xG
Ff
xG
xG
xG
xG
XY
XY
xG
XY
XY
XY
XY
"}
(65,1,1) = {"
XY
XY
XY
XY
XY
XY
XY
XY
XY
XY
XY
XY
XY
XY
XY
XY
XY
XY
XY
XY
XY
XY
XY
XY
vO
vO
vO
Xv
xG
XY
XY
XY
XY
XY
XY
XY
"}
(66,1,1) = {"
XY
XY
XY
XY
XY
XY
XY
XY
XY
XY
XY
XY
XY
XY
XY
XY
XY
XY
XY
XY
XY
XY
XY
XY
vO
vO
vO
vO
HB
XY
XY
XY
XY
XY
XY
XY
"}
(67,1,1) = {"
XY
XY
XY
XY
XY
XY
XY
XY
XY
XY
XY
XY
XY
XY
XY
XY
XY
XY
XY
XY
XY
XY
XY
XY
vO
vO
vO
na
xG
XY
XY
XY
XY
XY
XY
XY
"}
(68,1,1) = {"
XY
XY
XY
XY
XY
XY
XY
XY
XY
XY
XY
XY
XY
XY
XY
XY
XY
XY
XY
XY
XY
XY
XY
XY
XY
XY
XY
xG
xG
XY
XY
XY
XY
XY
XY
XY
"}
(69,1,1) = {"
XY
XY
XY
XY
XY
XY
XY
XY
XY
XY
XY
XY
XY
XY
XY
XY
XY
XY
XY
XY
XY
XY
XY
XY
XY
XY
XY
XY
XY
XY
XY
XY
XY
XY
XY
XY
"}
(70,1,1) = {"
XY
XY
XY
XY
XY
XY
XY
XY
XY
XY
XY
XY
XY
XY
XY
XY
XY
XY
XY
XY
XY
XY
XY
XY
XY
XY
XY
XY
XY
XY
XY
XY
XY
XY
XY
XY
"}
(71,1,1) = {"
XY
XY
XY
XY
XY
XY
XY
XY
XY
XY
XY
XY
XY
XY
XY
XY
XY
XY
XY
XY
XY
XY
XY
XY
XY
XY
XY
XY
XY
XY
XY
XY
XY
XY
XY
XY
"}
(72,1,1) = {"
XY
XY
XY
XY
XY
XY
XY
XY
XY
XY
XY
XY
XY
XY
XY
XY
XY
XY
XY
XY
XY
XY
XY
XY
XY
XY
XY
XY
XY
XY
XY
XY
XY
XY
XY
XY
"}
(73,1,1) = {"
XY
XY
XY
XY
XY
XY
XY
XY
XY
XY
XY
XY
XY
XY
XY
XY
XY
XY
XY
XY
XY
XY
XY
XY
XY
XY
XY
XY
XY
XY
XY
XY
XY
XY
XY
XY
"}
(74,1,1) = {"
XY
XY
XY
XY
XY
XY
XY
XY
XY
XY
XY
XY
XY
XY
XY
XY
XY
XY
XY
XY
XY
XY
XY
XY
XY
XY
XY
XY
XY
XY
XY
XY
XY
XY
XY
XY
"}
(75,1,1) = {"
XY
XY
XY
XY
XY
XY
XY
XY
XY
XY
XY
XY
XY
XY
XY
XY
XY
XY
XY
XY
XY
XY
XY
XY
XY
XY
XY
XY
XY
XY
XY
XY
XY
XY
XY
XY
"}
